ALLIGATOR	AE L AH G EY T ER
ANT	AE N T
BEAR	B EH R
BEE	B IY
BIRD	B ER D
CAMEL	K AE M AH L
CAT	K AE T
CHEETAH	CH IY T AH
CHICKEN	CH IH K AH N
CHIMPANZEE	CH IH M P AE N Z IY
COW	K AW
CROCODILE	K R AA K AH D AY L
DEER	D IH R
DOG	D AO G
DOLPHIN	D AA L F AH N
DUCK	D AH K
EAGLE	IY G AH L
ELEPHANT	EH L AH F AH N T
FISH	F IH SH
FLY	F L AY
FOX	F AA K S
FROG	F R AA G
GIRAFFE	JH ER AE F
GOAT	G OW T
GOLDFISH	G OW L D F IH SH
HAMSTER	HH AE M S T ER
HIPPOPOTAMUS	HH IH P AH P AA T AH M AH S
HORSE	HH AO R S
KANGAROO	K AE NG G ER UW
KITTEN	K IH T AH N
LEOPARD	L EH P ER D
LION	L AY AH N
LIZARD	L IH Z ER D
LLAMA	L AA M AH
LOBSTER	L AA B S T ER
MONKEY	M AH NG K IY
OCTOPUS	AA K T AH P UH S
OSTRICH	AO S T R IH CH
OTTER	AA T ER
OWL	AW L
OYSTER	OY S T ER
PANDA	P AE N D AH
PARROT	P EH R AH T
PELICAN	P EH L AH K AH N
PIG	P IH G
PIGEON	P IH JH AH N
PIGEON(2)	P IH JH IH N
PORCUPINE	P AO R K Y AH P AY N
PUPPY	P AH P IY
RABBIT	R AE B AH T
RABBIT(2)	R AE B IH T
RAT	R AE T
REINDEER	R EY N D IH R
RHINOCEROS	R AY N AA S ER AH S
ROOSTER	R UW S T ER
SCORPION	S K AO R P IY AH N
SEAL	S IY L
SHARK	SH AA R K
SHEEP	SH IY P
SHRIMP	SH R IH M P
SNAIL	S N EY L
SNAKE	S N EY K
SPARROW	S P EH R OW
SPIDER	S P AY D ER
SQUID	S K W IH D
SQUIRREL	S K W ER AH L
SWALLOW	S W AA L OW
SWALLOW(2)	S W AO L OW
SWAN	S W AA N
SWAN(2)	S W AO N
TIGER	T AY G ER
TOAD	T OW D
TORTOISE	T AO R T AH S
TURTLE	T ER T AH L
VULTURE	V AH L CH ER
WALRUS	W AO L R AH S
WEASEL	W IY Z AH L
WHALE	W EY L
WHALE(2)	HH W EY L
WOLF	W UH L F
ZEBRA	Z IY B R AH
