MONTGOMERY 	M AA N T G AH M R IY
JUNEAU 	JH UW N OW
PHOENIX 	F IY N IH K S
LITTLE-ROCK	L IH T AH L R AA K
SACRAMENTO 	S AE K R AH M EH N T OW
DENVER 	D EH N V ER
HARTFORD 	HH AA R T F ER D
DOVER 	D OW V ER
TALLAHASSEE 	T AE L AH HH AE S IY
ATLANTA 	AE T L AE N T AH
HONOLULU 	HH AA N AH L UW L UW
BOISE 	B OY Z IY
BOISE (2)	B OY S IY
SPRINGFIELD 	S P R IH NG F IY L D
INDIANAPOLIS	IH N D IY AH N AE P AH L IH S
DES-MOINES	D EH S M OY N Z
TOPEKA 	T AH P IY K AA
TOPEKA (2)	T OW P IY K AA
FRANKFORT 	F R AE NG K F ER T
BATON-ROUGE	B AE T AH N R UW JH
AUGUSTA 	AH G AH S T AH
ANNAPOLIS 	AH N AE P AH L IH S
BOSTON 	B AA S T AH N
BOSTON (2)	B AO S T AH N
LANSING 	L AE N S IH NG
SAINT-PAUL	S EY N T P AO L
JACKSON 	JH AE K S AH N
JEFFERSON-CITY	JH EH F ER S AH N S IH T IY
HELENA 	HH EH L AH N AH
LINCOLN 	L IH NG K AH N
CARSON-CITY	K AA R S AH N S IH T IY
CONCORD 	K AA N K AO R D
CONCORD (2)	K AA N K ER D
TRENTON 	T R EH N T AH N
SANTA-FE	S AE N T AH F EY
ALBANY	AO L B AH N IY
RALEIGH 	R AO L IY
BISMARCK 	B IH Z M AA R K
COLUMBUS 	K AH L AH M B AH S
OKLAHOMA-CITY	OW K L AH HH OW M AH S IH T IY
SALEM	S EY L AH M
HARRISBURG 	HH AE R IH S B ER G
HARRISBURG (2)	HH EH R IH S B ER G
PROVIDENCE	P R AA V AH D AH N S
COLUMBIA	K AH L AH M B IY AH
PIERRE	P IY EH R
NASHVILLE	N AE SH V IH L
AUSTIN	AO S T AH N
SALT-LAKE-CITY	S AO L T L EY K S IH T IY
MONTPELIER	M AA N T P IY L IY ER
RICHMOND 	R IH CH M AH N D
OLYMPIA	OW L IH M P IY AH
CHARLESTON	CH AA R L S T AH N
CHARLESTON(2)	CH AA R AH L S T AH N
MADISON 	M AE D AH S AH N
MADISON (2)	M AE D IH S AH N
CHEYENNE	SH AY EH N
